25,25
WWWWWWWWWWWWWWWWWWWWWWWWW
WPDDDDDDDDDDDDDDDDDDDDDDW
WDWWWWWWWWWWWWWWWWWWWWWDW
WDWDDDDDDDDDDDDDDDDDDDDDW
WDDDDDDDDDDDDDDDDDDDDDDDW
WDWDDDDDDDDDDDDDDDDDDDDDW
WDWDDDDDDDDDDDDDDDDDDDDDW
WDWDDDDDDDDDDDDDDDDDDDDDW
WDWDDDDDDDDDDDDDDDDDDDDDW
WDDDDDDDDDDDDDDDDDDDDDDDW
WDWDDDDDDDWWWWWDDDDDDDDDW
WDWDDDDDDDWEEEWDDDDDDDDDW
WDWDDDDDDDWEGEWDDDDDDDDDW
WDDDDDDDDDWEEEWDDDDDDDDDW
WDWDDDDDDDWWEWWDDDDDDDDDW
WDWDDDDDDDDDDDDDDDDDDDDDW
WDWDDDDDDDDDDDDDDDDDDDDDW
WDWDDDDDDDDDDDDDDDDDDDDDW
WDDDDDDDDDDDDDDDDDDDDDDDW
WDWDDDDDDDDDDDDDDDDDDDDDW
WDWDDDDDDDDDDDDDDDDDDDDDW
WDWDDDDDDDDDDDDDDDDDDDDDW
WDWDDDDDDDDDDDDDDDDDDDDDW
WDDDDDDDDDDDDDDDDDDDDDDDW
WWWWWWWWWWWWWWWWWWWWWWWWW